000100000001
000100000110
001000011000
001100100000
000100100100
000000100100
000100000100
011011000100
000000100100
110100100100
001000000100
000000011000