000000000000
111000000111
000101010000
000010100000
000000000000
101010101010
010101010101
000000000000
011011011000
100000000011
010101010101
010101010101