00000110000000110000
00001000000000001000
01000100000000000000
01011010000001110010
01010010011001001010
01001010000001011010
01000010000001000010
01111110000001010110
00000000000000101010
00000000000000000000
11111100100010010101
00000000100010001010
00000000100010000000
00001111100011111000
00000000000000000000
00000000000000000000
00111100111100111100
00000000000000000000
11110000000000001111
00000000000000000000