00000000001
110011001101
001000101011
010001101000
010110011010
010001000110
001110011011
010001100100
001100010100
010011100100
001100011011
000100000000