00000001000001000000
00011001000001001100
00010101000001010100
00001010000000101000
00000000001000000000
01010000011100010101
10101000101010001010
00000000001000000000
00010101000001010000
00001010000010101000
00000000000000000000
00000001010101000000
00000001101011000000
11111001000001001111
00001000000000001000
00001000000000001000
00001111100011111000
01000000000000000000
00100000000000000110
00100000000000000100