000100000000
000100000001
000011000110
000000100100
001100000100
000011000000
110000110000
001100000000
000100000000
000100111111
000000000000
000000000000