00001000000000000000
00011001000001110100
00100010011100001010
00011001100001000010
11100110011100110010
00011000100011001100
00100110011000110010
00001001100011001010
00101010011100101010
00101010100010101010
00101010100010101010
00100010010110101010
00101011001001101000
00101100110110011010
00110011000000100110
11001100110110011001
00110011001001100010
01001100110110001010
00110100000000011010
00010000000001100000
