001000001000
001000001000
001001001000
001001001000
000001001100
000110000000
001000010000
000001101100
110000000011
001100010000
000000100000
000000100000
