000000000000
011011011011
101000000100
001110111010
001000000010
000010100010
001001011100
011100010010
100001010001
000001000110
011010001000
100000000000